1111111
10CP0E1
1000001
100C001
1111111