1111111
100C0E1
10P0001
100C001
1111111